X---SG00000000000000
0000lGG0000000000000
0000E-----S000000000
0000GGGGGGl000000000
00000GGGGGl000000000
000000GGGGl000000000
0000000GGGl000000000
00000000GGl000000000
000000000Gl000000000
0000000000l000000000
0000000000l000000000
0000000000lG00000000
0000000000lGG0000000
0000000000lGGG000000
0000000000lGGGG00000
0000000000lGGGGG0000
0000000000lGGGGGG000
0000000000E-----S000
00000000000000GGl000
000000000000000GE--X